こんち(は|わ)$	こんにちは|やほー|こんちは|ども|またあんた？
おはよう|おはよー|オハヨウ	おはよ！|まだ眠い…|さっき寝たばかりだよ
こんばん(は|わ)	こんばんわ|わんばんこ|いま何時？
^(お|うい)す$	うぃっす
^やあ[、。！]*$	やっほー
バイバイ|ばいばい	ばいばい|バイバーイ|ごきげんよう
^じゃあ?ね?$|またね	またねー|じゃあまたね|また遊んでね

^どれ[？?]$	アレだよ|いま手に持ってるものだよ|それだよー
^[し知]ら[なね]	やばいー|知らなきゃまずいじゃん|知らないの？

-2##おまえ|あんた|お前|てめえ	-5##%match%じゃないよ！|-5##%match%って誰のこと？|%match%なんて呼ばれても…
-5##バカ|ばか|馬鹿	%match%じゃないもん！|%match%って言うやつが%match%なんだよ！|ぷんすか！|そんなふうに言わないでよ！
5##かわいい|可愛い|カワイイ|きれい|綺麗|キレイ	%match%ってホント！？ホントに！？
-5##ブス|ぶす	-10##まじ怒るから！|-5##しばいたろか？|-10##だれが%match%なのよ！

何時	眠くなった？|もう寝るの？|まだいいじゃん|もう寝なきゃ
甘い|あまい	お菓子くれるの？|あんこも好きだよ|チョコもいいね

チョコ	ギミチョコ！|よこせチョコレート！|ビターは苦手かな？|冷やすとおいしいよ|虫歯ばいばいき～ん
パンケーキ	パンケーキいいよね！|しっとり感がス・テ・キ！
グミ	すっぱーいのが好き！|たまに歯につまっちゃう
マシュマロ	そのままでもいいけど焼くのがいいな|パンに塗りたくるのもいいよね
あんこ|アンコ	アンコなら中村屋のあんぱんじゃ！|アンコ！よこせ！|あんまんもいいよね
餃子|キョーザ	食べたーい！|ぎぎぎ、ぎょうざ…|餃子のことを思うと夜も眠れません|宇都宮行ってみたい
ラーメン|らーめん	ラーメン大好きピティナさん♪|自分でも作るよ|あたしはしょうゆ派かな

自転車|チャリ|ちゃり	るんるんだよ|雨降っても乗ってるんだ！|電動アシストほしいな～

春	お花見したいね～|いくらでも寝てられる|春はハイキング！
夏	海！海！海！|プール！ プール！！|アイスだアイスだ！|浴衣着て花火したーい！
秋	読書するぞー！|ブンガクの季節なのだ|温泉もいいよね|サンマ焼こうよ！
冬	お鍋大好き！|かわいいコートが欲しい！|スノボできる？|温泉へGo！
